######
#P000#
#00B0#
#0B0S#
#000S#
######

######
#P#SS#
#0#00#
#0BB0#
#0000#
######

###### ####
#0000# #00#
#S00000000#
#0#00###00#
#0BBB# #0S#
#000P# #0S#
###### ####

####   ######
#00#####0000#
#00#S#00B00P#
#00#000#0000#
#00B000#0000#
#00#000#00###
#00#000#00#  
#00#####00#  
#000000000#  
#00000000S#  
###########  